11111111101
10100010201
10101111102
10000010101
10101111102
10101111102
10000010101
12111211101
10000010101
12111211101
12111211101
11111111101