11111111111
10100010211
10101111111
10000010111
11121211111
11111112111
11111111111